Abkhazia	Abkhazia
Adjara	Adjara
AK	AK
AL	AL
Alabama	AL
Ăland	Ăland
Alaska	AK
ALASKA	AK
American Samoa	AS
Andorra	Andorra
Angola	Angola
Antarctica	Antarctica
APO/FPO	APO/FPO
AR	AR
Argentina	Argentina
Arizona	AZ
ARIZONA	AZ
Arkansas	AK
Armenia	Armenia
Australia	Australia
Austria	Austria
AZ	AZ
AZ - Arizona	AZ
Bangladesh	Bangladesh
Barbados	Barbados
Belarus	Belarus
Belgium	Belgium
Belize	Belize
Bolivia	Bolivia
Bosnia and Herzegovina	Bosnia and Herzegovina
Brazil	Brazil
Brunei	Brunei
Bulgaria	Bulgaria
CA	CA
CA - California	CA
California	CA
CALIFORNIA	CA
California [CA]	CA
Canada	Canada
Chile	Chile
China	China
Christmas Island	Christmas Island
CO	CO
Colombia	Colombia
Colorado	CO
Connecticut	CT
Costa Rica	Costa Rica
Croatia	Croatia
CT	CT
Cuba	Cuba
Cyprus	Cyprus
Czech Republic	Czech Republic
Delaware	DE
Denmark	Denmark
Dist of Columbia	DC
Egypt	Egypt
El Salvador	El Salvador
England	England
Estonia	Estonia
Finland	Finland
FL	FL
Florida	FL
France	France
GA	GA
Georgia	GA
Germany	Germany
Gibraltar	Gibraltar
Greece	Greece
Guam	Guam
Guatemala	Guatemala
Hawaii	HI
Hong Kong	Hong Kong
Hungary	Hungary
Iceland	Iceland
Idaho	ID
IL	IL
IL - Illinois	IL
Illinois	IL
IN	IN
India	India
Indiana	IN
Indonesia	Indonesia
Iowa	IA
Iran	Iran
Ireland	Ireland
Israel	Israel
Italy	Italy
Jamaica	Jamaica
Japan	Japan
Jersey	Jersey
Kansas	KS
Kazakhstan	Kazakhstan
Kentucky	KY
KS	KS
Kuwait	Kuwait
KZN	KZN
LA	LA
Latvia	Latvia
Lithuania	Lithuania
Louisiana	LA
Luxembourg	Luxembourg
MA	MA
Macao	Macao
Macedonia	Macedonia
Maine	ME
Malaysia	Malaysia
Malta	Malta
MA - Massachusetts	MA
Maryland	MD
Massachusetts	MA
MD	MD
ME	ME
Mexico	Mexico
Mi	MI
MI	MI
Michigan	MI
Minnesota	MN
Mississippi	MS
Missouri	MO
MISSOURI	MO
MN	MN
MO	MO
Monaco	Monaco
Montana	MT
ND	ND
NE	NE
Nebraska	NE
Netherlands	Netherlands
Nevada	NV
New Caledonia	New Caledonia
New Hampshire	NH
New Jersey	NJ
New Mexico	NM
New York	NY
New Zealand	New Zealand
NH	NH
NH New Hampshire	NH
NJ	NJ
NJ - New Jersey	NJ
NM	NM
North Carolina	NC
North Dakota	ND
Norway	Norway
NV	NV
NY	NY
OH	OH
Ohio	OH
Ohio [OH]	OH
OH - Ohio	OH
OK	OK
Oklahoma	OK
OR	OR
Oregon	OR
OREGON	OR
Oregon/Ohio	OR
OR Oregon	OR
PA	PA
Pennsylvania	PA
Peru	Peru
Philippines	Philippines
Pitcairn Islands	Pitcairn Islands
Poland	Poland
Portugal	Portugal
Puerto Rico	Puerto Rico
Rhode Island	RI
Romania	Romania
Russia	Russia
Saint Lucia	Saint Lucia
Saudi Arabia	Saudi Arabia
SC	SC
Scotland	Scotland
SC - South Carolina	SC
SD	SD
Serbia	Serbia
Singapore	Singapore
Slovakia	Slovakia
Slovenia	Slovenia
South Africa	South Africa
South Carolina	SC
South Dakota	SD
South Korea	South Korea
Spain	Spain
St Louis	St Louis
Sweden	Sweden
Switzerland	Switzerland
Taiwan	Taiwan
Tennessee	TN
Tennessee [TN]	TN
texAS	TX
Texas	TX
Thailand	Thailand
Tn	TN
TN	TN
Turkey	Turkey
Tx	TX
TX	TX
TX-Texas	TX
Ukraine	Ukraine
United Arab Emirates	United Arab Emirates
United Kingdom	United Kingdom
United States	United States
United States of America	United States
Uruguay	Uruguay
US	United States
USA	United States
US Armed Forces - Americas	US Armed Forces - Americas
US Armed Forces - Europe	US Armed Forces - Europe
US Armed Forces - Pacific	US Armed Forces - Pacific
UT	UT
Utah	UT
UTAH (UT)	UT
VA	VA
Venezuela	Venezuela
Vermont	VT
Vietnam	Vietnam
Virginia	VA
WA	WA
Wales	Wales
Washington	WA
WA - Washington	WA
West Virginia	WV
WI	WI
Wisconsin	WI
WISCONSIN (WI)	WI
WY	WY
Wyoming	WY
